WWWWWWWWWWWWWWWWXXXW
WEEWEEWEEWEEWEEWEEEW
WEEWEEWEEWEEWEEWEEEW
WEEWEEWEEWEEWEEWEEEW
WEEWEEWEEWEEWEEWEEEW
WEEWEEWEEWEEWEEWEEEW
WEEWEEWEEWEEWEEWEEEW
WEEWEEWEEWEEWWWWEEEW
WEEWEEWEEWEEEEEEEEEW
WEEWEEWEEWWWWWWWEEEW
WEEWEEWEEEEEEEEWEEEW
WEEWEEWEEEEEEEEWEEEW
WEEWEEWEEEEEEEEWEEEW
WEEWEEWEEEEEEEEWEEEW
WEEWEEWWWWWWWWWWEEEW
WEEWEEEEEEEEEEEEEEEW
WEEWEEEEEEEEEEEEEEEW
WEEWEEWWWWWWWWWWWWWW
WEEWEEWEEEEEEEEEEEEW
WWWWSSWWWWWWWWWWWWWW