WWWWWWWWWWWWWWWWWWWWWWWWXXWWWWWWWWW
WEEWEEEWEEEWEWEEWEEWEWEWEEWEEWEEWEW
WEEWEEEWEEEWEWEEWEEWEWEWEEWEEWEEWEW
WEEWEEEWEEEWEWEEWEEWEWEWEEWEEWEEWEW
WEEWEEEWEEEWEWEEWEEWEWEWEEWEEWEEWEW
WEEWEEEWWEEWEWEEWEEWEWEWEEWEEWEEWEW
WEEWEEEWWEEWEWEEWEEWEWEWEEWEEWEEWEW
WEEWEEEWWEEWEWEEWEEWEWEWEEWEEWEEWEW
WEEWEEEWWEEWEWEEWEEWEWEWEEWEEWEEWEW
WEEWEEEWWEEWEWEEWEEWEWEWEEWEEWEEWEW
WEEWEEEWWEEWWWEEWEEWEWEWEEWEEWEEWEW
WEEWEEEWWEEWWEEEWWWWEWEWEEWEEWEEWEW
WEEWEEEWWEEWWEEEEEEEEWEWEEWWWWEEWWW
WEEWEEEWWEEWWEEEEEEEEWEWEEEEEEEEEEW
WEEWEEEWWEEWWEEWWWWWWWEWWWWWWWEEWWW
WEEWEEEWWEEWWEEWEEEEEWEWEEEEEWEEWEW
WEEWEEEEEEEWWEEWEEEEEWEWEEEEEWEEWEW
WEEWEEEEEEEWWEEWEEEEEWEWEEEEEWEEWEW
WEEWEEEEEEEWWEEWEEEEEWEWWWWWWWEEWEW
WEEWWWWWEEEWWEEWEEEEEWEEEEEEEEEEWEW
WEEWEEEWEEEWWEEWWWWWWWEWWWWWWWEEWEW
WEEWEEEWEEEWWEEWWEEEEEEWWWWWWWWWWEW
WEEWEEEWEEEWWEEEEEEEEEEEEEEEEWEEWEW
WEEWEEEWEEEWWEEEEEWWEEEEEEEEEWEEWEW
WEEWEEEWEEEWWEEEEEWWEEWWWWWWWWEEWEW
WEEWEEEWEEEEEEEEEEEEEEWEEEEEEWEEWEW
WEEWEEEWEEEEEEWWEEWWEEWEEEEEEWEEWEW
WEEEEEEWEEEEEEWWEEWWEEWEEEEEEWEEWEW
WEEEEEEWEEEEEEEEEEEEEEWEEEEEEWEEWEW
WEWWWWWWWWWWWEWWEEWWEEWEEEEEEWEEWEW
WEWWWWWWWWWWWEWWEEWWEEWWWWWWWWEEWWW
WEEEEEEEEEEEEEEEEEEEEEEEEEEEEEEEEEW
WWWWWWWWWWWWWWWWWWWWEEWWWWWWWWWWWWW
WEEEEEEEEEEEEEEEEEEWEEWEEEEEEEEEEEW
WWWWWWWWWWWWWWWWWWWWSSWWWWWWWWWWWWW