WWWWWXWWWWW
WEWWWEWWWEW
WEWWWEWWWEW
WEWEWWWEWEW
WEWEWEWEWEW
WEWEWEWEWEW
WEWWWWWWWEW
WEEEEEEEEEW
WWWWWSWWWWW