WWWWWWWWWXXXWWWWWWWWWWWWWWWWWW
WEEEWEEEEEEEEEEEWWWWWWWWWWWWWW
WEEEWEEEEEEEEEEEWEEEEEEEEEEEEW
WEEEWWWWWWWWWWWEWEWWWWWWWWWWWW
WEEEEEEEEEEEEEEEWEWWEEWEEEWEEW
WWWWWWWWWWEEEEEEWEWWEEWEEEWEEW
WWWEEEEEEWEEEEEEWEWWEEWEEEWEEW
WEWEEEEEEWEEEEEEWEWWEEWEEEWEEW
WEWEEEEEEWEEWWWWWEWWEEWEEEWEEW
WEWWEEEEEWEEEEEEEEWWEEWEEEWEEW
WEEWEEEEEWEEWWWWWWWWEEWEEEWEEW
WEEWWEEEEWEEWEEEWEEWEEWEEEWEEW
WEEEWWWWWWEEWEEEWEEWEEWEEEWEEW
WEEEWWEEEEEEWEEEWEEWEEWEEEWEEW
WEEEWWEEEEEEWEEEWEEWEEEEEEEEEW
WEEEWWEEEEEEWWEEWEEWWWWWEWWWWW
WEEEWWEWWWWWWWEEWWWWWWWWEWWWWW
WEEEEEEEEEEEEEEEEEEEEEEEEEEEEW
WWEEEEEEEEEEEEEEEEEEEEEEEEEEEW
WWWWWWWWWWEEWWWWWWWWWWWWWWWWEW
WEEEEEEEEWEEWEEEEEEEEEEEEEEWEW
WEEEEEEEEWEEWEEEEEEEEEEEEEEWEW
WEEWWWWWWWEEWWWWWWWWWWWWWWWWEW
WEEWEEEEEEEEEEEEEEEEEEEEEEEEEW
WEEWEEEEEEEEEEEEEEEEEEEEEEEEEW
WEEWEEWWWWWWWWWWWWWWWWWWWWWWWW
WEEWEEWEEEEEEEEEEEEEEEEEEEEEEW
WEEWEEWEEEEEEEEEEEEEEEEEEEEEEW
WEEWEEWEEEEEEEEEEEEEEEEEEEEEEW
WWWWSSWWWWWWWWWWWWWWWWWWWWWWWW