WWWWWXWWWWW
WWWWWEEEEEW
WWWWWWWWEWW
WWWEEEEEEWW
WWWEWWWWWWW
WEWEWEWEWEW
WEWEWEWEWEW
WEWEWEWEWEW
WEEEEEEEEEW
WWWWWSWWWWW