WWWWWWWWWWWWWWWWWWWXXXWWW
WEEWEEEEEEEEEEEEEEWEEEWEW
WEEWEEEEEEEEEEEEEEWEEEWEW
WEEWEEWWWWWWWWWWWWWEEEWEW
WEEWEEWEEEEEEEEEEEEEEEWEW
WEEWEEWEEWWWWWWWWWWWWWWEW
WEEWEEWEEEEEEEEEEEEEEEWEW
WEEWEEWEWWWWWWWWWWWWWWWEW
WEEWEEWEWEEEEEEEEEEEEEEEW
WEEWEEWEWEEEEEWWWWWWWWWEW
WEEWEEWEWEEWWWWEEEEEEEEEW
WEEWEEWEEEEWEEWWWWWWWWWEW
WEEWEEWEEEEWEEWEEEEEEEWEW
WEEWEEWEEEEWEEWEEEEEEEWEW
WEEWEEWEEEEWEEWWWWWWWWWEW
WEEWEEWEEEEWEEEEEEEEEEEEW
WWEWEEWEEEEWWWWWWWWWWWEEW
WWEEEEEEEEEEEEEEEEEEEWEEW
WWEEEEEEEEEEEEEEEEEEEWEEW
WWWWWWWEEEEEEEEEEEEEEWEEW
WWWWWWWEEWWWWWWWWWWWWWEEW
WWEEEEEEEEEEEEEEEEEEEEEEW
WWEEEEEEEEEEEEEEEEEEEEEWW
WWEEWWWWWWWWWWWWWWWWWWWWW
WWSSWWWWWWWWWWWWWWWWWWWWW